{
  "mazeData": [
    [
      [1, 0, 0, 0],
      [1, 0, 1, 0],
      [0, 0, 1, 1],
      [0, 0, 1, 1],
      [0, 0, 1, 1],
      [0, 0, 1, 1],
      [1, 0, 0, 1],
      [1, 0, 1, 0],
      [1, 0, 0, 1],
      [1, 0, 0, 0]
    ],
    [
      [1, 1, 0, 0],
      [1, 1, 0, 0],
      [1, 0, 1, 0],
      [1, 0, 0, 1],
      [1, 0, 1, 0],
      [0, 0, 1, 1],
      [1, 1, 0, 1],
      [1, 1, 0, 0],
      [1, 1, 0, 0],
      [1, 1, 0, 0]
    ],
    [
      [1, 1, 0, 0],
      [0, 1, 1, 0],
      [0, 1, 0, 1],
      [1, 1, 0, 0],
      [0, 1, 1, 0],
      [1, 0, 0, 1],
      [0, 1, 1, 0],
      [0, 1, 0, 1],
      [0, 1, 0, 0],
      [1, 1, 0, 0]
    ],
    [
      [0, 1, 1, 0],
      [0, 0, 1, 1],
      [0, 0, 1, 1],
      [0, 1, 0, 1],
      [1, 0, 0, 0],
      [1, 1, 0, 0],
      [1, 0, 1, 0],
      [0, 0, 1, 1],
      [1, 0, 0, 1],
      [1, 1, 0, 0]
    ],
    [
      [1, 0, 1, 0],
      [0, 0, 1, 1],
      [0, 0, 1, 1],
      [1, 0, 0, 1],
      [1, 1, 0, 0],
      [1, 1, 1, 0],
      [0, 1, 0, 1],
      [1, 0, 1, 0],
      [0, 1, 0, 1],
      [1, 1, 0, 0]
    ],
    [
      [1, 1, 0, 0],
      [1, 0, 1, 0],
      [1, 0, 0, 1],
      [1, 1, 1, 0],
      [0, 1, 0, 1],
      [1, 1, 0, 0],
      [1, 0, 0, 0],
      [1, 1, 0, 0],
      [1, 0, 1, 0],
      [0, 1, 0, 1]
    ],
    [
      [0, 1, 1, 0],
      [0, 1, 0, 1],
      [1, 1, 0, 0],
      [0, 1, 1, 0],
      [0, 0, 1, 1],
      [0, 1, 0, 1],
      [1, 1, 0, 0],
      [1, 1, 0, 0],
      [0, 1, 1, 0],
      [1, 0, 0, 1]
    ],
    [
      [1, 0, 1, 0],
      [0, 0, 1, 1],
      [1, 1, 1, 1],
      [0, 0, 1, 1],
      [0, 0, 1, 1],
      [0, 0, 1, 1],
      [1, 1, 0, 1],
      [1, 1, 1, 0],
      [0, 0, 1, 1],
      [0, 1, 0, 1]
    ],
    [
      [1, 1, 0, 0],
      [1, 0, 0, 0],
      [1, 1, 0, 0],
      [0, 0, 1, 0],
      [0, 0, 1, 1],
      [1, 0, 0, 1],
      [1, 1, 0, 0],
      [0, 1, 0, 0],
      [1, 0, 1, 0],
      [1, 0, 0, 1]
    ],
    [
      [0, 1, 1, 0],
      [0, 1, 0, 1],
      [0, 1, 1, 0],
      [0, 0, 1, 1],
      [0, 0, 1, 1],
      [0, 1, 0, 1],
      [0, 1, 1, 0],
      [0, 0, 1, 1],
      [0, 1, 0, 1],
      [0, 1, 0, 0]
    ]
  ],
  "startCoord": [0, 0],
  "destinationCoord": [9, 9]
}
